<render>{
    Resolution    :     1080 x 720;
    Type          :     Textured;
    Sky : #FF00FF
}

<player>{
    Health        : 100;
    Stamina       : 69;
    Position      : (1, 1);
    View_distance : 20;
}

<env>{
    (1,wall)    : ./textures/brick.xpm;
    (2,floor)    : ./textures/brick.xpm;
}

<map>{
    2 2 2 2 2 2 2 2 2 2 2 2 2 2 2 2 2 2 2 2 2 2 2 2 2 2 2 2 2 2
    1 2 1 1 2 2 2 1 1 1 1 2 1 1 1 1 1 1 1 2 1 1 1 1 1 2 1 2 1 1
    1 2 2 1 1 1 1 1 2 2 1 1 2 2 2 1 2 2 1 2 2 1 2 2 1 2 1 1 1 2
    1 1 2 1 2 2 2 2 2 2 2 1 1 1 2 1 2 2 1 2 2 1 2 1 1 2 1 2 1 2
    2 1 2 1 1 1 2 1 1 2 1 1 2 1 2 1 1 2 1 2 1 1 2 1 2 2 1 2 1 1
    1 1 2 2 2 2 2 1 2 2 1 2 2 1 2 2 1 2 1 1 1 2 2 1 1 2 1 2 2 2
    1 2 1 1 1 1 2 1 1 1 1 1 2 1 2 2 1 2 2 2 1 1 1 2 1 2 1 1 1 2
    1 2 1 2 2 2 2 2 2 2 2 2 2 1 1 2 1 1 1 2 2 2 2 2 1 2 2 2 1 1
    1 1 1 2 2 1 1 1 1 1 1 1 1 2 1 2 2 2 1 1 1 1 1 2 1 1 1 2 2 1
    2 2 2 1 2 1 2 2 2 2 2 2 2 2 1 1 1 1 2 2 2 2 1 2 2 2 1 1 2 1
    1 1 2 1 2 1 2 1 2 1 1 1 1 1 2 2 2 1 2 1 1 1 1 2 1 2 2 1 2 1
    2 1 2 1 2 1 1 1 2 1 2 1 2 2 2 2 1 1 2 2 2 1 2 2 1 1 2 1 2 1
    1 1 2 1 2 2 2 2 1 1 2 1 2 1 1 1 1 2 2 2 1 1 2 2 1 2 2 1 1 1
    1 2 2 1 2 2 1 1 1 2 2 1 1 1 2 2 2 2 1 1 1 2 1 1 1 2 2 2 1 2
    1 1 2 1 2 1 1 2 2 2 2 2 2 2 2 2 1 1 1 2 2 2 2 2 1 2 1 1 1 2
    2 1 2 1 2 1 2 1 1 1 1 1 1 1 2 1 1 2 1 1 2 1 1 1 1 2 1 2 2 1
    1 1 1 1 2 1 2 2 2 1 2 2 2 1 2 2 2 2 2 1 2 2 2 1 2 2 1 2 2 1
    1 2 1 2 2 2 1 1 2 1 1 1 2 1 1 1 1 1 2 1 2 1 1 1 2 1 1 2 2 1
    2 2 1 1 1 2 2 1 1 2 2 1 2 2 2 2 2 1 1 1 2 2 1 2 2 1 2 2 1 1
    1 1 1 2 1 2 2 2 1 1 2 1 1 2 1 1 2 2 2 2 1 1 1 1 1 1 1 1 1 2
    1 2 2 2 1 2 2 2 2 1 2 2 1 1 1 2 2 1 2 2 1 2 2 2 2 2 2 2 1 1
    1 1 1 2 2 1 1 1 2 1 1 1 2 2 1 1 2 1 1 1 1 2 1 1 1 1 2 2 2 1
    1 2 1 2 2 1 2 1 2 2 2 2 2 1 2 1 1 2 2 2 2 1 1 2 2 1 2 1 1 1
    1 2 1 2 1 1 2 1 1 1 2 1 2 1 2 2 1 1 2 1 1 1 2 2 2 1 2 1 2 2
    1 2 1 1 1 2 1 1 2 2 2 1 2 1 2 2 2 1 1 1 2 1 1 2 1 1 2 1 2 1
    1 2 2 2 2 2 1 2 1 1 1 1 2 1 2 2 2 2 2 2 2 2 1 2 1 2 2 1 1 1
    1 2 1 2 1 1 1 2 2 2 1 2 2 1 1 1 1 2 1 1 1 2 1 2 1 1 2 2 2 1
    1 1 1 2 1 2 1 1 2 2 2 2 2 2 2 2 1 1 1 2 1 1 2 2 2 1 1 1 2 1
    2 1 2 2 1 2 2 2 2 1 2 1 1 2 1 1 2 2 2 2 2 1 1 1 2 1 2 1 2 1
    1 1 1 2 1 1 2 1 1 1 2 1 2 2 2 2 2 1 1 1 2 2 2 2 2 2 2 1 2 1
    1 2 1 2 2 1 1 1 2 1 1 1 2 1 1 1 1 1 2 1 1 1 1 2 1 1 1 1 2 1
    2 2 2 2 2 2 2 2 2 2 2 2 2 2 2 2 2 2 2 2 2 2 2 2 2 2 2 2 2 2
}