<env>{
    (1,wall)    : ./textures/banner.xpm;
}

<map>{
    0 1 1 1 1 1 1 1 1 1 1 1 1 0
    0 0 0 0 0 1 0 1 0 0 0 0 0 0 
    0 0 0 0 0 1 0 1 0 0 0 0 0 0
    0 0 0 0 0 1 0 1 0 0 0 0 0 0
    0 0 0 0 0 0 0 0 0 0 0 0 0 0
    0 0 0 0 0 0 0 0 0 0 0 0 0 0  
    0 0 0 0 0 1 0 1 0 0 0 0 0 0  
    0 0 0 0 0 1 0 1 0 0 0 0 0 0  
    0 0 0 0 0 1 0 1 0 0 0 0 0 0
    0 1 1 1 1 1 1 1 1 1 1 1 1 0  
}